###########
#.........#
#.#.#####.#
#.#.......#
#.#@#####.#
#...#.....#
###.#.#####
#.........#
###########
...........
