#.......#.
#.#####.#
#.#...#.#
#.#.#.#.#.
#.#.#...#.
#.#@#####.
#.........
#########.
..........
..........