...###
.....#.####
.....###..#
..........#
#...@..#..#
..#..###..#
..#..#....#
.##.##.#.##
.#......##
.#.....##
.##...##